- Nirvana - The man who sold the world
- Jimi Hendrix - all along the watchtower
- Murray Head - say it ain't so, Joe
- The Lumineers - ophelia
- John Lennon - imagine
- Babyshambles - carry on up the morning
- Leonard Cohen - hallelujah
- Metronomy - the look
- Scorpions - still loving you
- Led Zeppelin - stairway to heaven
- Arthur Lee - everybody's gotta live
- Bill Whiters - ain't no sunshine
- Allan Rayman - rose
- Depeche Mode - where's the revolution
- KISS - i was mode for lovin' you
- Metallica - fade to black
- Parcels - overnight
- Jonnhy Cash - hurt
- Dire Straits - sultans of swing
- Moriartry - jimmy
- Eric Clapton - layla
- David Bowie - space oddity
- Green Day - boulevart of broken dream
- Linkin Park - numb
- Radiohead - exit music (for a film)
- Red Hot - snow
- Them - gloria
- Eagles - hotel california
- Aerosmith - dream on
- Oasis - wonderwall
- R.E.M. - losing my religion
- Pixies - where is my mind ?
- Michael Kiwanuka - hero
- Michael Jackson - billie jean
- Liam Gallagher - for what it's worth
- The Heavy - how you like me now?
- Baxter Dury - miami
- Warhaus - mad world
- Arctic Monkeys - why'd you only call me when you're high?
- Nick Cave - red right hand
- Noir Désir - l'homme pressé
- Téléphone - cendrillon
- Indochine - 3 nuits par semaine
- Elton John - i'm still standing
- Madcon - beggin
- Feu! Chatterton - un monde nouveau
- The Black Keys - going down south
- Bruno Mars - Locked out of heaven
- Mark Ronson - Uptown Funk
- London Grammar - wasting my young years
- Bob Dylan - hurricane
- Axel Bauer - cargo
- Ram Jam - black betty
- Queen - another one bites the dust
- BB Brunes - dis-moi
- Bruce Springsteen - the river
- Woodkid - iron
- Barry Moore- hey now
- B.B. King - lucille
- Texas - the conversation
- AC/DC - highway to hell
- ZZ Top - la grange
- Cigarettes After Sex - nothing's gonna hurt you baby
- The Rolling Stones - angie
- The Cure - lullaby
- Lukas Graham - 7 years
- Coldplay - something, just like this
- Supertramp - breakfast in america
- Her - five minutes
- Hervé - si bien du mal
- Kaleo - no good
- Mickey 3d - respire
- Superbus - butterfly
- Sting - shape of my heart
- Police - roxanne
- Imagine Dragons - believer
- Louise Attaque - ton invitation
- Gorillaz - clint eastwood
- The Animals-  house of the rising sun
- Isaac Delusion - she pretends
- Pink Floyd - another brick in the wall, pt2
- The Score - unstoppable
- Alt-J - in cold blood
- The Beatles - while my guitar gently weeps
- Paul Mccartney - maybe i'm amazed
- The Doors - break on through
- Guns N' Roses - sweet child o' mine
- Rage Against The Machine - bombtrack
- The Clash - london calling
- The Cranberries - zombie
- U2 - sunday bloody sunday
- The Strokes - the adults are taking
- Foo Fighters - everlong
- Pearl Jam - even flow
- Genesis - jesus he knows me
- Muse - hysteria
- Elvis Presley - jailhouse rock
- Neil Young - harvest moon
- Deep Purple - smoke on the water
- Phil Collins - against all odds
- Simon & Garfunkel - the sound of silence
- Rod Stewart - baby jane
- The Do - on my shoulders
- Van Halen - jump
- The Alan Parsons Project - i wouldn't to be like you
- James Brown - it's a man's, man's, man's world
- Bronski Beat - smalltown boy
- Iggy Pop - the passenger
- Mike Oldfield - moonlight shadows
- LP - lost on you
- The Roots - the seed
- A-HA - take on me
- Chuck Berry - johnny be goode
- Shaka Ponk - my name is stain
- Santana - europa
- The Monkees - i'm a believer
- The Beach Boys - i get around
- Patti Smith - because the night
- Charlie Winston - like a hobo
- Amy Winehouse - back to black
- Madness - one step beyond
- Bonnie Tyler - total eclipse of the heart
- Barclay James Harvest - child of the universe
- The Who - behind blue eyes
- Joy Division - love will tear us apart
- Stevie Wonder - part-time lover
- Black Sabath - paranoid
- Ramones - blitzkrieg bop
- The White Stripes - seven nation army
- Survivor - eye of the tiger
- The Kinks - you really got me
- Ben E. King - stand by me
- Kool & The Gang - celebration
- Diana Ross - upside down
- Joan Jett - i love rock 'n roll
- Joan Baez - Here's to you
- Blondie - call me
- Silly Boy Blue - the fight
- Terrenoire - jusqu'à mon dernier souffle
- Iron Maiden - the trooper
- Slipknot - snuff
- The Raconteurs - steady, as she goes
- Lynyrd Skynyrd - sweet home alabama
- Hozier - take me to church
- L'impératrice - vacances
- Daft Punk - voyager
- Juliette Armanet - le dernier jour du disco
- Celeste - stop this flame
- Milky Chance - save your tears
- Dafuniks - all i want
- Jungle - keep moving
- Gaël Faye - kerozen
- Calogero - celui d'en bas
- Chinese Man - i've got that tune
- Concorde - sons
- The Kills - doing it to death
- Maribou State - steal
- Fugees - no woman, no cry
- Balthazar - losers
- Pharell Williams - freedom
- The Unlikely Candidates - bells
- Raphaël - caravane
- Yseult - corps
- Tom Odell - another love
- Lord Huron - the night we met
- Noé Preszow - que tout s'danse
- Suzane - l'appart vide
- Lous And The Yakuza - dilemme
- Pomme - vide
- Chagrin d'Amour - chacun fait (c'qui lu plait)
- Bon Entendeur - le temps est bon
- Ben Mazué - tu m'auras tellement plu
- Nick Waterhouse - i feel an urge coming on
- Eminem - the real slim shady
- Petit Biscuit - sunset lover
- Eddy de Pretto - normal
- Asaf Avidan - one day
- Sam Smith - money on my mind
- M - manitoumani 
- David Gilmour - rattle that lock
- MC Solaar - obsolète
- Odezenne - une danse de mauvais goût 
- Diam's - la boulette
- Orelsan - changement
- Abd al Malik - le marseillais
- Lucio Bukowski - P'tit con
- STUPEFLIP - stupeflip vite !!!
- Hugo TSR - rei
- Disiz - qu'ils ont de la chance
- JoeyStarr - mamy ...
- IAM -petit frère
- Gringe - scanner
- Dooz Kawa - sous la pluie
- Anton Serra - aimer tue
- Brigitte - hier encore
- C2C - down the road
- Simple Minds - don't you (forget about me)
- Village People - YMCA
- Sarah Cothran - as the world caves in
- The Weeknd - save your tears
- Slash - 30 Years to life
